~~####~~
~~#ss#~~
~~#..#~~
~~#1.#~~
###..###
#.1....#
#...1..#
#......#
#......#
#...n..#
########

########
#......#
#..###2#
#.1#s..#
#..####~
##....#~
~#.1..#~
~#..n.#~

~~~~~~~~
~..ss..~
~.2....~
~~..2.~~
~~....~~
~~1..2~~
~~....~~
~~~n.~~~
~~~~~~~~

##########
#s#.#...1#
#3...2...#
#.....####
#.#.#..#2#
#...#..#.#
#3###2##.#
#..#.....#
##.#n....#
##########
